5
3
1
1
1
1 1 1 1 1
2 2 2 2 2
3 3 4 5 3
0 0 0 0 0
0 0 0 0 0
0 0 0 0 0
0
0